5 5 5 5 5 5 5 5 5 5 5 5 5 5 5 5 5 5 
5 0 0 0 0 0 0 0 0 0 0 0 0 0 0 2 2 5 
5 0 0 0 0 0 0 0 0 0 0 0 0 0 0 2 2 5 
5 0 0 0 0 0 0 0 0 0 0 0 0 0 2 2 2 5 
5 0 0 0 0 0 0 0 0 0 0 0 2 2 2 2 0 5 
5 0 0 0 0 0 0 0 0 2 2 2 2 2 2 0 0 5 
5 0 0 0 0 0 0 2 2 2 2 2 2 0 0 0 0 5 
5 0 0 0 2 2 2 2 2 2 2 0 0 0 0 0 0 5 
5 0 0 2 2 2 2 2 0 0 0 0 0 0 0 0 0 5 
5 0 2 2 2 2 0 0 0 0 0 0 0 0 0 0 0 5 
5 0 2 2 2 0 0 0 0 0 0 0 0 0 0 0 0 5 
5 0 4 3 4 0 0 0 0 0 0 0 0 0 0 0 0 5 
5 4 4 4 4 4 0 0 0 0 0 0 0 0 0 0 0 5 
5 5 5 5 5 5 5 5 5 5 5 5 5 5 5 5 5 5